R 955 500

NO ./textures/circle.xpm

SO ./textures/panic.xpm
WE ./textures/black_corr.xpm
EA ./textures/white_brick.xpm
S ./textures/pillar.xpm

F 220,000,700
C 220,100,600

11111111111111111111111111111111
10000000010000011000000000000001
10010001000000000000000000000001
10010011111111111111111111111111
10010000000000011000000000000001
11110000000000000000000000000001
10010000111111111111100000000001
10010000000000000000000000000001
10011111111111110011111111111111
10000000000000011000010000000001
10000000000000011000010000000001
10000011110000000000000000N00001
10000000001000011000000000000001
10000100001000011000010000200001
10000011110000011000010000000001
10000000000000011000010000000001
10000000000000011020010000000001
11111111111111111111111111111111
