R 955 800

NO ./textures/circle.xpm
SO ./textures/panic.xpm
WE ./textures/black_corr.xpm
EA ./textures/white_brick.xpm
S ./textures/pillar.xpm

F 220,100,0

1111111111111111111111111111111
1000000000110000000000000000001
1011000001110000000000000000001
1001000000000002000000000000001
1111111101100000111000000000001
1000000000110000001101111111111
1111011111111101100000001000001
1111111100000000000000000000001
1110000001000000111111111111111
1100000011010100010000001000001
1000000000000000000000000000001
1000000000000000110101000000001
1100000101010100111101111000111
111101100111010001011110100S001
1111111111111111111111111111111
