R 1080 700

NO ./textures/circle.xpm
SO ./textures/panic.xpm
WE ./textures/black_corr.xpm
EA ./textures/painture_b.xpm

S ./textures/pillar.xpm
F 220,000,700
C 220,000,700

111111111111111111111111111111111111111111111111
100000000000000000000001000000000000000000000001
100000000000000000000001000000000000000000000001
100000000000000000000001000000000000000000000001
100000111110000101010001000000000000000000000001
100000100010000000000000000000000000000000000001
100000100010000100010000000000000000000000000001
100000110110000111110000000000000000S00000000001
100000000000000000000001111111111111111111111101
100000000000000000000001000000000000000000000001
111111111111111111111111111111111111111111111111
